Country	AB	EF	KP	PA	SA	SUM
Egypt	2	0	0	0	0	2
Italy	1	0	0	1	0	2
Germany	2	0	0	15	0	17
Pakistan	0	0	1	0	0	1
-	8	0	0	1	0	9
Lebanon	2	0	0	1	0	3
USA	3	0	0	4	0	7
Netherlands	0	0	0	2	0	2
Brazil	8	0	0	1	0	9
France	0	0	0	28	0	28
Singapore	0	0	0	1	0	1
Peru	1	0	0	0	0	1
Argentina	0	0	0	3	0	3
Ukraine	0	0	0	1	0	1
United_Kingdom	1	0	0	0	0	1
Spain	5	0	0	6	0	11
Greece	1	0	0	1	0	2
